txnExternalId,location,description,status,currency,amount,txnAmount,txnCurrency,timestamp,lastNumbers,cardHolderName,transactionDate,type,merchantCategoryName,mcc,walletName,authIndicator,cardAcceptorName,authCode,note,receiptIds,receiptMatchingStatus,fee,companyAccountingCode,companyAccountingCodeName,balance,credit,debit,userId,hasThreeDs,label,reviewStatus
"984ea361-d278-4c61-9193-5b83fbb52b04",,"Funds removed from card","APPROVED","EUR","-255.35",,,"2025-02-27T16:13:00Z","3276","conor wogan",,"ADJUSTMENT",,,,"OTHERS",,,,"[]","NULL",,,,,,"255.35",,,"Developer Tools","NOT_STARTED"
"2d1074d8-2651-4345-a52d-020b38fc183d","AXIOM AI PRO          +447590057363GB",,"APPROVED","EUR","-47.82","-50","USD","2025-02-26T11:13:56Z","3276","conor wogan",,"PURCHASE","Computer Software Stores","5734",,"ONLINE","AXIOM AI PRO","CBLVWY",,"[]","NULL",,,,"255.35",,"47.82",,,"Developer Tools","NOT_STARTED"
"8cbc223f-8683-4347-bf90-85d5ab819b18","APPLE.COM/IE          1850-88-20-48IE",,"APPROVED","EUR","-99","-99","EUR","2025-01-20T12:28:36Z","3276","conor wogan",,"PURCHASE","Electronics Stores","5732",,"ONLINE","APPLE.COM/IE","CBLOBN",,"[]","NULL",,,,"303.17",,"99",,,"Developer Tools","NOT_STARTED"
"82c17d78-75e2-4bb0-864b-34461b9a147c","PLACEIT EMPOWERKIT    SAN FRANCISCOUS","17 - Customer cancellation","APPROVED","EUR","0.92","1","USD","2024-11-05T08:05:20Z","3276","conor wogan",,"REVERSAL","Computers, Peripherals, and Software","5045",,"OTHERS","PLACEIT EMPOWERKIT","CBL2KC",,"[]","NULL",,,,"402.44","0.92",,,,"Developer Tools","NOT_STARTED"
"40965d34-ee93-4ebb-bc66-409047a1157d","PLACEIT EMPOWERKIT    SAN FRANCISCOUS",,"APPROVED","EUR","-9.01","-9.78","USD","2024-11-05T08:05:11Z","3276","conor wogan",,"PURCHASE","Computers, Peripherals, and Software","5045",,"ONLINE","PLACEIT EMPOWERKIT","CBLSQB",,"[]","NULL","-0.27",,,"401.52",,"9.01",,,"Developer Tools","NOT_STARTED"
"a1c7e283-f09e-4dde-b9b5-04778b590cca","PLACEIT EMPOWERKIT    SAN FRANCISCOUS",,"APPROVED","EUR","-0.92","-1","USD","2024-11-05T08:05:09Z","3276","conor wogan",,"PURCHASE","Computers, Peripherals, and Software","5045",,"OTHERS","PLACEIT EMPOWERKIT","CBL2KC",,"[]","NULL",,,,"410.53",,"0.92",,,"Developer Tools","NOT_STARTED"
"f6fa4df7-5c1d-45c5-8452-6876a3cb88db","Register365           D04TR29      IE",,"APPROVED","EUR","-3.68","-3.68","EUR","2024-07-22T16:18:09Z","3276","conor wogan",,"PURCHASE","Computer Network Services","4816",,"ONLINE","Register365","CBLJRY",,"[]","NULL",,,,"411.45",,"3.68",,,"Developer Tools","NOT_STARTED"
"82d17250-1076-4b18-8532-543979ef44e2","JetBrains             Prague       CZ",,"APPROVED","EUR","-84.87","-84.87","EUR","2024-05-17T15:34:46Z","3276","conor wogan",,"PURCHASE","","5817",,"ONLINE","JetBrains","CBLKLP",,"[]","NULL",,,,"415.13",,"84.87",,,"Developer Tools","NOT_STARTED"
"cd9ef9da-94f5-4b87-b6e4-257467294c0b",,"Card Activated","APPROVED","EUR","500",,,"2024-05-17T15:27:33Z","3276","conor wogan",,"CARD_ACTIVATION",,,,"OTHERS",,,,"[]","NULL",,,,,"500",,,,"Developer Tools","NOT_STARTED"