txnExternalId,location,description,status,currency,amount,txnAmount,txnCurrency,timestamp,lastNumbers,cardHolderName,transactionDate,type,merchantCategoryName,mcc,walletName,authIndicator,cardAcceptorName,authCode,note,receiptIds,receiptMatchingStatus,fee,companyAccountingCode,companyAccountingCodeName,balance,credit,debit,userId,hasThreeDs,label,reviewStatus
"9af34747-276b-4209-bd5a-ae0431f527b0",,"Funds removed from card","APPROVED","EUR","-0.45",,,"2024-04-17T11:39:18Z","0307","Amy Healy",,"ADJUSTMENT",,,,"OTHERS",,,,"[]","NULL",,,,,,"0.45",,,"Amy Healy Charger (11 May 2023)","NOT_STARTED"
"ac52a205-da7a-06b4-2106-7748453c3df8","NYA*MGDA - MAINTENANCEParis        FR",,"APPROVED","EUR","-0.8","-0.8","EUR","2023-05-19T15:10:47Z","0307","Amy Healy",,"PURCHASE","Miscellaneous Food Stores - Convenience Stores and Specialty Markets","5499","Apple Pay","IN_STORE","NYA*MGDA - MAINTENANCE","CBLYVQ",,"[]","NULL",,,,"0.45",,"0.8",,,"Amy Healy Charger (11 May 2023)","NOT_STARTED"
"009e6771-2874-438f-d229-6a881770dd7d","FLOR FRANCE           NICE         FR",,"APPROVED","EUR","-2.6","-2.6","EUR","2023-05-19T15:07:13Z","0307","Amy Healy",,"PURCHASE","Bakeries","5462","Apple Pay","IN_STORE","FLOR FRANCE","CBL0HP",,"[]","NULL",,,,"1.25",,"2.6",,,"Amy Healy Charger (11 May 2023)","NOT_STARTED"
"94a9c8ab-c2cc-e56f-59bb-e596e01c89aa","LE PETIT CASI         NICE         FR",,"APPROVED","EUR","-1","-1","EUR","2023-05-16T12:21:55Z","0307","Amy Healy",,"PURCHASE","Hardware Stores","5251","Apple Pay","IN_STORE","LE PETIT CASI","CBLXSF",,"[]","NULL",,,,"3.85",,"1",,,"Amy Healy Charger (11 May 2023)","NOT_STARTED"
"521be330-0438-1c62-c7ed-89833967ba75","SAS GANI              NICE         FR",,"APPROVED","EUR","-1.03","-1.03","EUR","2023-05-16T07:00:32Z","0307","Amy Healy",,"PURCHASE","Grocery Stores, Supermarkets","5411","Apple Pay","IN_STORE","SAS GANI","CBLVCN",,"[]","NULL",,,,"4.85",,"1.03",,,"Amy Healy Charger (11 May 2023)","NOT_STARTED"
"4e5e5faa-b9e4-b68d-d681-63f57590c417","CAFE BAR NOIS         NICE         FR",,"APPROVED","EUR","-6.1","-6.1","EUR","2023-05-16T06:55:34Z","0307","Amy Healy",,"PURCHASE","Eating Places, Restaurants","5812","Apple Pay","IN_STORE","CAFE BAR NOIS","CBLTMP",,"[]","NULL",,,,"5.88",,"6.1",,,"Amy Healy Charger (11 May 2023)","NOT_STARTED"
"7ac4422b-9ff1-4d03-144a-9c142e427009","SAS  SAS ABCDIS       NICE         FR",,"APPROVED","EUR","-13.02","-13.02","EUR","2023-05-15T17:42:29Z","0307","Amy Healy",,"PURCHASE","Grocery Stores, Supermarkets","5411","Apple Pay","IN_STORE","SAS  SAS ABCDIS","CBLDPN",,"[]","NULL",,,,"11.98",,"13.02",,,"Amy Healy Charger (11 May 2023)","NOT_STARTED"
"664588b6-866a-43b4-9053-45d28b63d900",,"Card Activated","APPROVED","EUR","25",,,"2023-05-11T13:28:57Z","0307","Amy Healy",,"CARD_ACTIVATION",,,,"OTHERS",,,,"[]","NULL",,,,,"25",,,,"Amy Healy Charger (11 May 2023)","NOT_STARTED"