txnExternalId,location,description,status,currency,amount,txnAmount,txnCurrency,timestamp,lastNumbers,cardHolderName,transactionDate,type,merchantCategoryName,mcc,walletName,authIndicator,cardAcceptorName,authCode,note,receiptIds,receiptMatchingStatus,fee,companyAccountingCode,companyAccountingCodeName,balance,credit,debit,userId,hasThreeDs,label,reviewStatus
"bf132601-07d5-4d10-a183-f4875104976b",,"Funds removed from card","APPROVED","EUR","-4.76",,,"2024-04-17T11:45:04Z","2082","Sean Wogan",,"ADJUSTMENT",,,,"OTHERS",,,,"[]","NULL",,,,,,"4.76",,,"General Expenses","NOT_STARTED"
"3aeb09f7-082a-fb62-4442-a6774cf88999","Food Crew             Beacon Court IE",,"APPROVED","EUR","-8.5","-8.5","EUR","2024-02-15T12:55:59Z","2082","Sean Wogan",,"PURCHASE","Eating Places, Restaurants","5812","Apple Pay","IN_STORE","Food Crew","CBLKIK",,"[]","NULL",,,,"4.76",,"8.5",,,"General Expenses","NOT_STARTED"
"ce5f3f68-f986-3cfe-cbad-aa0817e09e8f","DUNNES BEACON COURT   DUBLIN       IE",,"APPROVED","EUR","-7.14","-7.14","EUR","2024-01-09T13:20:05Z","2082","Sean Wogan",,"PURCHASE","Grocery Stores, Supermarkets","5411","Apple Pay","IN_STORE","DUNNES BEACON COURT","CBLCSX",,"[]","NULL",,,,"13.26",,"7.14",,,"General Expenses","NOT_STARTED"
"ac419e9e-3b7a-d5eb-6db0-dad0dca26f74","BROTHER BEAN COFFEE   DUBLIN       IE",,"APPROVED","EUR","-11.5","-11.5","EUR","2023-12-19T12:34:56Z","2082","Sean Wogan",,"PURCHASE","Miscellaneous Food Stores - Convenience Stores and Specialty Markets","5499","Apple Pay","IN_STORE","BROTHER BEAN COFFEE","CBL1G6",,"[]","NULL",,,,"20.4",,"11.5",,,"General Expenses","NOT_STARTED"
"6bd594ce-a481-97bf-f64a-66c359580b70","CAFE BLISS            SANDYFORD BUSIE",,"APPROVED","EUR","-7.5","-7.5","EUR","2023-12-12T14:09:41Z","2082","Sean Wogan",,"PURCHASE","Eating Places, Restaurants","5812","Apple Pay","IN_STORE","CAFE BLISS","CBLLBD",,"[]","NULL",,,,"31.9",,"7.5",,,"General Expenses","NOT_STARTED"
"ccd33ac9-2a09-7989-730d-029636e34082","Food Crew             Beacon Court IE",,"APPROVED","EUR","-3.35","-3.35","EUR","2023-11-21T13:33:47Z","2082","Sean Wogan",,"PURCHASE","Eating Places, Restaurants","5812","Apple Pay","IN_STORE","Food Crew","CBLGOE",,"[]","NULL",,,,"39.4",,"3.35",,,"General Expenses","NOT_STARTED"
"cce33be5-b106-bb06-a279-c587d4a75af1","CAFE BLISS            SANDYFORD BUSIE",,"APPROVED","EUR","-7.25","-7.25","EUR","2023-11-21T13:23:19Z","2082","Sean Wogan",,"PURCHASE","Eating Places, Restaurants","5812","Apple Pay","IN_STORE","CAFE BLISS","CBLGZ2",,"[]","NULL",,,,"42.75",,"7.25",,,"General Expenses","NOT_STARTED"
"ae0cb44d-ed5d-9b3b-2618-c1fe6ab83309",,"Card Activated","APPROVED","EUR","50",,,"2023-11-21T11:32:48Z","2082","Sean Wogan",,"CARD_ACTIVATION",,,,"OTHERS",,,,"[]","NULL",,,,,"50",,,,"General Expenses","NOT_STARTED"